#############
#...........#
#...........#####
#..............c#
#..............c#
#..............c#
#..............##
#D.............#
################