#########################
#.............#.........#
#.............#c........#
#.............####......#
#.......................#
#.............##.########
#D............#c........#
#########################