#################################
#....................###........#
#.....k..D..U........#M#........#
#....................###........#
#.....A..L..Y...................#
#....................###........#
#.....H..1..c........#N#........#
#....................###........#
#...............................#
#...............................#
#################################

1 Beispieltext